NO ./assets/textures/test.xpm
SO ./assets/textures/test.xpm
EA ./assets/textures/test.xpm
WE ./assets/textures/test.xpm

F 255,30,60
C 210,210,30

11111111111111111111111
10000000000000000000001
10000000000000000000001
10000111110000101010001
10000100010000000S00001
10000100010000100010001
10000100010000000000001
10000111110000101010001
10000000000000000000001
10000000000000000000001
10000000000000000000001
10000000000000000000001
10000000000000000000001
10000000000000000000001
10000000000000000000001
10000000000000000000001
11111111100000000000001
11000000100000000000001
11000010100000000000001
11000000100000000000001
11011111100000000000001
11000000000000000000001
11111111100000000000001
11111111111111111111111
