    111111111
    1E0000001
    11111000111
    10001000001
111110001000001
100000001000001
100111000011111
1N01 100001
1111 111111
