11111    111111111
10001    1E0000001
10001    11111000111
11111    10001000001
     111110001000001
11111100000000000000
10000000100000011111
1001110000111111
1001 100001
1001 111111
1111
